###############
#.#...........#
#$###~###x###.#
#.............#
#.#######1#####
#.............#
###~#####-###.#
#.............#
#.#####-#####-#
#....#........#
####.#.######.#
#......#......#
###x####.######
#r............#
###############
pink 1 13 
blue 13 13
red 13 5 
carrot 1 1 2
carrot 1 7 2
carrot 2 13 2
carrot 7 13 2
