###############
#.............#
#.##x##.##_##.#
#.#___#_#___#.#
#.#_#.#.#.#_#.#
#.#___#_#__1#.#
#.#####.#####.#
#.............#
#.#####.#####.#
#.#___#_#___#.#
#.#_#.#.#.#_#.#
#.#3__#_#___#.#
#.##_##.##_##.#
#.............#
###############
pink 3 4 
blue 9 13
red 3 9 
carrot 5 3 2
carrot 9 3 2
carrot 5 9 2
carrot 9 9 2
carrot 7 1 2
carrot 7 13 2
