###############
#...#.....#...#
#1#.#.###.#.#4#
#.............#
####.##-##.####
#....#___#....#
#.##.#####.##.#
#..#.......#..#
##.#.##.##.#.##
#.............#
#.#.##.#.##.#.#
#3#..#.#.#..#2#
#.##.#.#.#.##.#
#.............#
###############
pink 6 5
blue 7 5
red 8 5
carrot 1 1 2
carrot 6 1 2
