###############
#...#.....#...#
###.#.#1#.#.###
#.............#
#.##.##.##.##.#
#....#...#....#
#.##.##.##.##.#
#3.#.......#.4#
##.#.##.##.#.##
#.............#
#.##-##.#.###.#
#.#___#~#...#.#
#.#####.###.#.#
#......2......#
###############
pink 3 11
blue 4 11
red 5 11
carrot 13 13 2
carrot 1 13 2
