###############
#.............#
#1#.#.#.#.#.#4#
#.............#
#.#.#.#.#.#.#.#
#.............#
#.#.#.#.#.#.#.#
#.............#
#.#.#.#.#.#.#.#
#.............#
#.#.#.#.#.#.#.#
#3...........2#
#-#.#.#.#.#.#.#
#_#...........#
###############
pink 1 13
blue 1 13
red 3 13
carrot 1 1 2
carrot 1 13 2
carrot 13 1 2
carrot 13 13 2
