###############
#.............#
#3#.#####.#.#2#
#...#...#.....#
#.#.#.#.#.###.#
#...#...#.....#
#.###.#.#.###.#
#.............#
#.#.#.#.#-#.#.#
#.....#...#...#
#.###.#.#.#.#-#
#1....#...#.#4#
#-#.#.#####.#.#
#_#...........#
###############
pink 1 13
blue 1 13
red 3 13
carrot 5 13 1
carrot 5 1 1
