###############
#1#...#...#..##
#...#...#..#..#
#.####.###..#$#
#.........#...#
#.###3###..#.##
#.......##.#..#
#.#####..#.##.#
#......#.#.#..#
#.####.#.....##
#...r#.#.#.#..#
#.##.#.#.#.##.#
#..#.#.#.#.#.2#
##...........##
###############
pink 1 12
blue 2 12
red 2 13
carrot 1 1 1
carrot 12 13 1
