###############
#3...........4#
#~#$###.###$#~#
#.....#x#.....#
#.###.#_#.###.#
#.###.#_#.###.#
#.###.#~#.###.#
#.............#
#.#.#.#.#.#.#.#
#...#..#..#...#
###.#.#.#.#.###
#.............#
#.##.#####.##.#
#1.....#r....2#
###############
pink 7 5
blue 7 5
red 7 5
carrot 1 1 2
carrot 1 13 2
carrot 13 6 2
carrot 13 8 2
