###############
#.....3#r.....#
#.###########.#
#......1......#
#.#..##-##..#.#
#...##___##...#
#.#.#######.#.#
#.....#.#.....#
#x###.....###~#
#....#####....#
#.##.#.2.#.##.#
#......#......#
#-####$$$####-#
#......#......#
###############
pink 6 5
blue 7 5
red 8 5
carrot 1 1 2
carrot 1 13 2
carrot 13 6 2
carrot 13 8 2
